100 100
..............oo....o..........o...................................................................o
................................o.......................o.........................o.................
............o........o..........o.......................o...............o......o....o...............
.......o.......o....................o.........o....................................................o
.........o......o.......o...........o......................................o.....o..................
...................o..................................o..............o..............................
........o....o......o...........................o...................................................
...o.........................o.....o...o.............................o..............................
.................................o.....o.................o...............................o..........
...........................................o.........o.........................o.............o.....o
..o...o.......o......................o.............o................................................
......................................o...o......................................o..o..............o
..........................o.....................................................o...................
..........................o............................o.................o..o..o.....o.........o..o.
............................................o.......................................................
.o..................o...................o....................o....o.........o......o....o....o..o...
........o.....................o..................................o.......o......o...................
...........................o...............o...................................o.....o..............
.......................................................o..o..........o.......................o......
..................o.........................................o...............o......................o
..............o................o....oo...........oo..o..............................................
.........................o.....o.............o...o....................................o..o..........
..............o..............o......................................o......o.........oooo.o...o.....
...o......o...o...................................................o.................................
o......................o...o.o...............o............o..............................o..........
......o.................o.......................o............o......................o...o...........
...........................o................o......o......................................oo........
...o........o....................................o.................................o....o...o.......
...o.................o.............o......o...................o...............o...........o.........
.........................o...............o...............................o...o......................
..o.......o..............o.....o............o....o............o........o..o.o........o..........o...
..........................................................o........................o................
.............................................................o....o................................o
o...............o...............o.........o.o....o..............................................o...
................................o....o............o.........o......................o................
........................o.........................o...o.....................o.............o.........
.o..........o....................................................o..o...............o...............
.......o..........................o.........o....o.................o...................o............
......................o..............................................o..........o...................
...o...............o.....oo......................................o..................o...............
....o...................o.....................o.....................o......o........................
........................o.........................o.........o..o...o......oo............o...........
.................o................................................o.......o......o....o.............
...................o.....o.........o...o.........................o..................................
...........o....................................................................................o.o.
...................o.......................................................................o...o.o..
...................................................o................................................
o...oo.........o....o..........o............o.................o..............................o......
.....................o......o...............................................oo..........o...........
.......o.......o..................................o..............................................o..
..o.................o...................o.................o.........................................
......................................oo.....o.......................................o..............
...o........................o.....o............o....................................................
................o.o............o......o.o...........o......o....o.................oo................
.......................o...........o..o....o.......o.o...........o..................................
............................o...............o......................................o................
................o....................o...........o........o...........o................oo...........
..................o.........................o...................................................o...
.........o..oo.......o....o.......o......................................o..............o...........
...........o...................................................................o....................
.............................o.......................................o.............o....o...........
.......o................o....o................o.......o..........o..................................
.............o.......................o...........o....o.oo.........o.....o.....o.............o......
..................o.................o..............o....o.........o..............................o..
..o........o.................o................................................o.....................
...........o........................o.o.............o......o...............o..o................o....
........................o....o.........................................................o............
....o...............o..o........................o..........................o.....o..................
..o....................o.............o..............................................................
................................................o................o.......o.......o..o.o.............
..........o....................................oo.................................................o.
..........................................................................................o...o.....
..................o..........................o.........o.....................o.....................o
...............................o...............o................o....o.....o........................
....o.................o..................................................o.....oo...................
o.....o.......................................o..........o......o........o.o..............o..o.o....
...................................o...............................o..................o....o........
...........................o...........................o....o............o........................o.
.....................o...................o.............................................o..........o.
..............o..........o...................o............o....o....o....................o........o.
........o........oo..........................................................o......................
.o................o........................................o...............................o........
............................................................oo........o.............................
..........o.......o......................o.......................................o..................
...............o..............o..............o...................o..................................
.o..o........................o...................................oo.................................
..............................................................................o....................o
....................o...................o...oo.....o............................o...................
........................o.............o..........o...................o..............................
............o.................................................o.............o...............o.......
......o.............................o...o....................o..............o...................o...
...................o.o.....oo......................o......o............................o............
...............o..o.................................................................................
...................o...........o...o...........................................o...............o....
...................................o......o........o...................o............................
........o.....................o.....o..............o.o..............................................
o..........................o.............................................................o..........
....................................o..............o...............................o................
............................o.............................................o.....o...................
...............o...o..o.......o..................................o.........o............o...........
